XXXXXXXXXXXXXXXXXXXXXXXXXXXXXXXXXXXXXXXX
X                                      X
X                                      X
X                                      X
X                                      X
X                                      X
X                                      X
X                                      X
X                                      X
X                                      X
X                                      X
X                                      X
X                                      X
X                                      X
X              XXXXXXXXXX              X
X                                      X
X                                      X
X                                      X
X                                      X
X                                      X
X                                      X
X                                      X
X                                      X
X                                      X
X                                      X
X                                      X
X                                      X
X                                      X
X                                      X
XXXXXXXXXXXXXXXXXXXXXXXXXXXXXXXXXXXXXXXX